111111111111111111111111111111111111111
1000000P000000000000000000000000000E001
1000000000000000C0000000000000000000001
111111111111111111111111111111111111111
