111111111111111111111111111111
111111111000000000000000011111
100000000000000000111000100001
110000100000000000000000001111
100P01111111000000000000111111
111111100000000010000000000001
111100000000001100000000000011
110000000000011110000000000011
100000000000111000000000000011
110000C00000111000000000001111
11000000000111100000E000000111
111111111111111111111111111111
