111111
110001
100001
110001
100P01
111001
110001
10E001
1100C1
110001
111111
