111111111111111111111111111111111111111111
1P0010C000000010010000000010000000000000E1
101111101111101010001100011100000000000001
100000000000101010001100000000000000000001
101111111111101010001100000000000000000001
100000000000100010001100000000000000000001
100000000000110110001100000000000000000001
100000000000000000001100000000000000000001
100000000000000000001100000000000000000001
100000000000000000001100000000000000000001
100000000000000000001100000000000000000001
100000000000000000001100000000000000000001
100000000000000000001100000000000000000001
100000000000000000001100000000000000000001
100000000000000000001100000000000000000001
100000000000000000001100000000000000000001
100000000000000000001100000000000000000001
100000000000000000001100000000000000000001
100000000000000000001100000000000000000001
100000000000000000001100000000000000000001
100000000000000000001100000000000000000001
100000000000000000001100000000000000000001
100000000000000000001100000000000000000001
111111111111111111111111111111111111111111
